OBBOOOGO
OBBOOOOO
OBBOOUUO
OBBUOOOO
OOOBOOOO
OSOOOOOO