UUUGOUUUUU
UUUUUOUUUU
UUUUUOUUUU
SOOUUOUUUU
UUUOUOUUUU
UUUUOUUUUU